a's	-apple
ab's	-apple bee
abc's	-apple bee comb
acclivity	- dốc ngược
acclivous	- dốc ngược
accolade	- sự ôm hôn, sự gõ nhẹ sống gươm lên vai (khi phong tước)- (âm nhạc) dấu gộp
accommodate	- điều tiết, làm cho thích nghi, làm cho phù hợp- hoà giải, dàn xếp- (+ with) cung cấp, cấp cho, kiếm cho- chứa được, đựng được- cho trọ; tìm chỗ cho trọ- giúp đỡ, làm ơn
accommodating	- dễ dãi, dễ tính, xuề xoà- hay giúp đỡ, sẵn lòng giúp đỡ, hay làm ơn
accommodation	- sự điều tiết, sự thích nghi, sự làm cho phù hợp- sự điều tiết (sức nhìn của mắt)- sự hoà giải, sự dàn xếp- tiện nghi, sự tiện lợi, sự thuận tiện- chỗ trọ, chỗ ăn chỗ ở- món tiền cho vay
accommodation train	- (từ Mỹ,nghĩa Mỹ) xe lửa địa phương (ở địa phương)
accommodation unit	- nơi ở
accommodation-ladder	-,lædə/- (hàng hải) thang, thang dây (ở bên sườn tàu thuỷ để lên xuống các xuồng nhỏ)
accompaniment	- vật phụ thuộc, vật kèm theo; cái bổ sung- (âm nhạc) sự đệm (dàn nhạc); phần nhạc đệm
accompanist	- (âm nhạc) người đệm (nhạc, đàn)
accompany	- đi theo, đi cùng, đi kèm, hộ tống- phụ thêm, kèm theo- (âm nhạc) đệm (đàn, nhạc)
accomplice	- kẻ tòng phạm, kẻ đồng loã
accomplish	- hoàn thành, làm xong, làm trọn- thực hiện, đạt tới (mục đích...)- làm (ai) hoàn hảo, làm (ai) đạt tới sự hoàn mỹ (về nhạc, hoạ, nữ công...)
accomplished	- đã hoàn thành, đã làm xong, xong xuôi, trọn vẹn- được giáo dục kỹ lưỡng, có đầy đủ tài năng; hoàn hảo, hoàn mỹ (về nhạc, hoạ, nữ công...)
accomplishment	- sự hoàn thành, sự làm xong, sự làm trọn- sự thực hiện (mục đích...)- việc đã hoàn thành, việc làm xong, ý định đã thực hiện được; thành quả, thành tựu, thành tích- (số nhiều) tài năng, tài nghệ (về nhạc, hoạ, nữ công...); (xấu) tài vặt
accord	- sự đồng lòng, sự đồng ý, sự tán thành- hoà ước- sự phù hợp, sự hoà hợp- (âm nhạc) sự hợp âm- ý chí, ý muốn- làm cho hoà hợp- cho, ban cho, chấp thuận, chấp nhận- (+ with) phù hợp với, hoà hợp với, thống nhất với, nhất trí với
accordance	- sự đồng ý, sự thoả thuận (với ai)- sự phù hợp, sự theo đúng (cái gì)- sự cho, sự ban cho
accordant	- ((thường) + with) thích hợp, phù hợp, hoà hợp với, theo đúng với
according	- (+ to) theo, y theo- (+ as) tuỳ, tuỳ theo
accordingly	- do đó, vì vậy, cho nên- (sao) cho phù hợp (với hoàn cảnh)- (+ as) (như) according as
accordion	- (âm nhạc) đàn xếp, đàn ăccoc
accordionist	- người chơi đàn xếp, người chơi đàn ăccooc
accost	- đến gần- bắt chuyện- gạ gẫm; níu, kéo, bám sát (nói về gái điếm)- sự chào
accouchement	- sự đẻ
accoucheur	- người đỡ đẻ
accoucheuse	- nữ hộ sinh, bà đỡ
account	- sự tính toán- sự kế toán; sổ sách, kế toán- bản kê khai; bản thanh toán tiền, bản ghi những món tiền phải trả- sự thanh toán- sự trả dần, sự trả làm nhiều kỳ- tài khoản, số tiền gửi- lợi, lợi ích- lý do, nguyên nhân, sự giải thích- báo cáo, bài tường thuật; sự tường thuật, sự miêu tả- sự đánh giá, sự chú ý, sự lưu tâm- tầm quan trọng, giá trị- theo sự đánh giá chung, theo ý kiến chung- (xem) balance- (như) according to all accounts- (xem) go- bắt phải báo cáo sổ sách, bắt phải báo cáo mọi khoản thu chi; bắt phải giải thích (về cái gì...)-(đùa cợt); (thông tục) nôn mửa- giả mạo sổ sách (kế toán); bịa ra một khoản, kê khai giả mạo một khoản- đòi báo cáo sổ sách; bắt phải giải thích (việc gì...)- gây được tiếng tốt cho mình; (thể dục,thể thao) thắng lợi, đạt được kết quả tốt- (tôn giáo) ngày tận thế- (từ Mỹ,nghĩa Mỹ) thoát nợ đời; chết- đánh giá cao, coi trọng- mong đợi ở cái gì; hy vọng ở cái gì- không quan tâm đến, không để ý đến, không đếm xỉa đến- vì mình, vì lợi ích của mình, vì mục đích của mình- tự mình phải gánh lấy mọi sự xảy ra- vì ai- thanh toán với ai- trả thù ai, thanh toán mối thù với ai- coi, coi như, coi là, cho là- (+ for) giải thích (cho)- giải thích (việc sử dụng, thanh toán, tính toán tiền nong)- (thể dục,thể thao) bắn được, hạ được
accountability	- trách nhiệm, trách nhiệm phải giải thích
accountable	- chịu trách nhiệm, có trách nhiệm phải giải thích- có thể nói rõ được, có thể giải thích được
accountancy	- nghề kế toán
accountant	- nhân viên kế toán, người giữ sổ sách kế toán- (pháp lý) người có trách nhiệm báo cáo về sổ sách kế toán; người bị can về một vụ tiền nong kế toán
accountantship	- chức kế toán
accounting	- sự thanh toán, sự tính toán (tiền nong, sổ sách)- sự giải thích
accoutre	- mặc cho (bộ đồ đặc biệt...); trang bị cho
accoutrement	- bộ áo quần đặc biệt; quần áo- (quân sự) đồ trang bị (cho người lính, trừ quần áo, súng)
accredit	- làm cho người ta tin (ý kiến, tin tức, tin đồn...)- làm cho được tín nhiệm, gây uy tín cho (ai...)- uỷ nhiệm làm (đại sứ...)- (+ to,  with) gán cho, quy cho, đổ cho
accredited	- được chính thức công nhận (người); được mọi người thừa nhận (tin tức, ý kiến, tin đồn...)
accrescent	- (thực vật học) cùng phát triển, cùng lớn lên
accrete	- cùng phát triển, cùng lớn lên thành một khối- bôi dần lên quanh một hạt nhân, phát triển dần lên quanh một hạt nhân- (thực vật học) lớn lên
accretion	- sự lớn dần lên, sự phát triển dần lên, - sự bồi dần vào- phần bồi thêm, phần phát triển dần lên- (pháp lý) sự tăng thêm (của cải, tài sản...)
accretive	- lớn dần lên, phát triển dần lên- được bồi dần vào
accrual	- sự dồn lại, sự tích lại- số lượng dồn lại, số lượng tích lại
accrue	- (+ to) đổ dồn về (ai...)- (+ from) sinh ra (từ...), do... mà ra- dồn lại, tích luỹ lại (tiền lãi...)
accruement	- sự dồn lại, sự tích lại- số lượng dồn lại, số lượng tích lại
accumulate	- chất đống, chồng chất, tích luỹ, gom góp lại- làm giàu, tích của- thi cùng một lúc nhiều bằng (ở trường đại học)
accumulation	- sự chất đống, sự chồng chất, sự tích luỹ, sự tích lại, sự tích tụ, sự góp nhặt- sự làm giàu, sự tích của- sự tích thêm vốn (do lãi ngày một đẻ ra)- đống (giấy má, sách vở...)- sự thi cùng một lúc nhiều bằng (ở trường đại học)
accumulative	- chất đống, chồng chất; tích luỹ được, góp nhặt được- thích tích luỹ của cải, ham làm giàu (người)
accumulator	- người tích luỹ- người thích làm giàu, người trữ của- (vật lý) ăcquy- người thi cùng một lúc nhiều bằng (ở trường đại học)
accuracy	- sự đúng đắn, sự chính xác; độ chính xác
accurate	- đúng đắn, chính xác, xác đáng
accurateness	- sự đúng đắn, sự chính xác; độ chính xác
accursal	- sự kết tội, sự buộc tội; sự bị kết tội- sự tố cáo- cáo trạng
accursed	- đáng nguyền rủa, đáng ghét, ghê tởm- xấu số, phận rủi, phận hẩm hiu- phiền toái, khó chịu
accurst	- đáng nguyền rủa, đáng ghét, ghê tởm- xấu số, phận rủi, phận hẩm hiu- phiền toái, khó chịu
accusation	- sự kết tội, sự buộc tội; sự bị kết tội- sự tố cáo- cáo trạng
accusative	- (ngôn ngữ học) (thuộc) đổi cách- (ngôn ngữ học) đổi cách
accusatorial	- buộc tội, kết tội; tố cáo
accusatory	- buộc tội, kết tội; tố cáo
accuse	- buộc tội, kết tội; tố cáo
accuser	- uỷ viên công tố, người buộc tội- nguyên cáo
accustom	- làm cho quen, tập cho quen
accustomed	- quen với; thành thói quen, thành thường lệ
ace	- (đánh bài) quân át, quân xì; điểm 1 (trên quân bài hay con súc sắc)- phi công xuất sắc (hạ được trên mười máy bay địch); vận động viên xuất sắc; người giỏi nhất (về cái gì...); nhà vô địch- (thể dục,thể thao) cú giao bóng thắng điểm; điểm thắng giao bóng (quần vợt)- chút xíu- (từ Mỹ,nghĩa Mỹ),  (thông tục) quân bài chủ cao nhất dành cho lúc cần đến (đen & bóng)- người bạn có thể dựa khi gặp khó khăn- phi công ưu tú nhất- người xuất sắc nhất trong những người xuất sắc- quân bài chủ cao nhất- giữ kín quân bài chủ cao nhất dành cho lúc cần- cắt quân át của ai bằng bài chủ- gạt được một đòn ác hiểm của ai
acephalous	- không có đầu- không có tướng, không có người cầm đầu; không chịu nhận ai là người cầm đầu- (thông tục) cụt đầu, bị chặt ngọn- thiếu âm đầu (câu thơ)
acerbate	- làm tăng, làm trầm trọng (bệnh, sự tức giận, sự đau đớn)- làm bực tức, làm cáu tiết, làm tức giận
acerbity	- vị chát, vị chua chát- tính chua chát, tính gay gắt (giọng nói...)
acerose	- (thực vật học) hình kim (lá thông, lá tùng...)
acerous	- (thực vật học) hình kim (lá thông, lá tùng...)
acervate	- (thực vật học) mọc thành chùm
acescent	- hoá chua; chua
acetate	- (hoá học) Axetat
acetic	- (hoá học) axetic; (thuộc) giấm
acetification	- sự hoá giấm; sự làm thành giấm
acetify	- làm thành giấm- hoá chua; hoá thành giấm
acetone	- axeton
acetous	- chua, có vị giấm
acetylene	- (hoá học) Axetylen
ache	- sự đau, sự nhức- đau, nhức, nhức nhối- (nghĩa bóng) đau đớn
achene	- (thực vật học) quả bế
achievable	- có thể đạt được, có thể thực hiện được
achieve	- đạt được, giành được- hoàn thành, thực hiện
achievement	- thành tích, thành tựu- sự đạt được, sự giành được; sự hoàn thành- huy hiệu, huy chương (để ghi nhớ một thành tích vẻ vang)
achilles	- A-sin (anh hùng cổ Hy lạp)
aching	- sự đau đớn (vật chất, tinh thần)
achlamydeous	- (thực vật học) không bao hoa, có hoa trần
achromatic	- (vật lý) tiêu sắc- không màu, không sắc
achromatism	- (vật lý) tính tiêu sắc- tính không màu, tính không sắc
achromatize	- (vật lý) làm tiêu sắc- làm thành không màu, làm thành không sắc
achromatous	- không màu, không sắc
achromous	- (vật lý) làm tiêu sắc- làm thành không màu, làm thành không sắc
acicular	- hình kim; kết tinh thành hình kim
acid	- (hoá học) Axit- chất chua- Axit- (nghĩa bóng) thử thách gay go- chua- chua cay, gay gắt; gắt gỏng
acid-proof	-resisting) - chịu axit
acid-resisting	-resisting) - chịu axit
acidic	- có tính chất axit
acidification	- (hoá học) sự axit hoá
acidifier	- (hoá học) chất axit hoá
acidify	- Axit hoá- thành axit, hoá chua
acidimeter	- cái đo axit
acidity	- tính axit; độ axit- vị chua
acidly	- chua chát, gay gắt
acidose	- (y học) sự nhiễm axit
acidulate	- làm cho hơi chua- pha axit
acidulated	- hơi chua- có pha axit
acidulous	- hơi chua- có pha axit- chua cay, gay gắt (lời nói)
aciform	- hình kim
ack emma	- (thông tục) (như) ante_meridiem- (thông tục) (như) air-mechanic
ack-ack	- súng cao su- tiếng súng cao xạ- sự bắn súng cao xạ
acknowledge	- nhận, thừa nhận, công nhận- báo cho biết đã nhận được- đền đáp; tỏ lòng biết ơn, cảm tạ
acknowledgement	- sự nhận, sự công nhận, sự thừa nhận- vật đền đáp, vật tạ ơn; sự đền đáp- sự báo cho biết đã nhận được (thư...)
acknowledgment	- sự nhận, sự công nhận, sự thừa nhận- vật đền đáp, vật tạ ơn; sự đền đáp- sự báo cho biết đã nhận được (thư...)
aclinic	- (vật lý) không nghiêng, vô khuynh
acme	- tột đỉnh, đỉnh cao nhất- (y học) thời kỳ nguy kịch nhất (của bệnh)
acock	- đội lệch (mũ)
acolyte	- (tôn giáo) thầy tu cấp dưới, thầy dòng, thầy tăng- người theo hầu
aconite	- (thực vật học) cây phụ tử
acorn	- (thực vật học) quả đầu
acotyledon	- (thực vật học) cây không lá mầm
acotyledonous	- (thực vật học) không lá mầm
acoumeter	- cái đo nghe
acoustic	- (thuộc) âm thanh; (thuộc) âm học- (thuộc) thính giác
acoustician	- nhà âm học
acoustics	- âm học- (số nhiều) độ vang âm (của một rạp hát, rạp chiếu bóng...)
acquaint	- làm quen- báo, cho biết, cho hay
acquaintance	- sự biết, sự hiểu biết- sự quen, sự quen biết- ((thường) số nhiều) người quen- người quen sơ sơ- bỏ rơi một người quen, lờ một người quen- cố làm quen bằng được với ai- (xem) speaking- (xem) strike
acquaintanceship	- sự quen biết
acquainted	- ((thường) + with) quen biết, quen thuộc (với)
acquest	- vật kiếm được, của cải làm ra- (pháp lý) của làm ra (không do thừa kế)
acquiesce	- bằng lòng, ưng thuận, đồng ý; bằng lòng ngầm, mặc nhận
acquiescence	- sự bằng lòng, sự ưng thuận, sự đồng ý; sự bằng lòng ngầm, sự mặc nhận- sự phục tùng
acquiescent	- bằng lòng, ưng thuận, đồng ý; bằng lòng ngầm, mặc nhận- phục tùng
acquire	- được, giành được, thu được, đạt được, kiếm được
acquirement	- sự được, sự giành được, sự thu được, sự đạt được, sự kiếm được- (số nhiều) điều học được, học thức, tài nghệ, tài năng (do trau giồi mà có, đối lại với thiên tư)
acquisition	- sự được, sự giành được, sự thu được, sự đạt được, sự kiếm được- cái giành được, cái thu nhận được
acquisitive	- thích trữ của, hám lợi- có thể học hỏi, có khả năng tiếp thu, có khả năng lĩnh hội
acquisitiveness	- tính thích trữ của, tính hám lợi- tính có thể học hỏi, khả năng tiếp thu, khả năng lĩnh hội
acquit	- trả hết, trang trải (nợ nần)- to acquit oneself of làm xong, làm trọn (nghĩa vụ, bổn phận...)- làm bổn phận mình, làm trọn phận mình; xử sự
acquittal	- sự trả xong nợ, sự trang trải xong nợ nần- sự tha tội, sự tha bổng, sự tuyên bố trắng án- sự làm trọn (bổn phận, trách nhiệm...)
acquittancce	- sự trả nợ, sự trang trải hết nợ nần- sự trang trải hết nợ nần- biên lai
acre	- mẫu Anh (khoảng 0, 4 hecta)- cánh đồng, đồng cỏ
acreage	- diện tích (tính theo mẫu Anh)
acrid	- hăng, cay sè- chua cay, gay gắt (lời nói, thái độ...)
acridity	- vị hăng, mùi hăng, mùi cay sè- sự chua cay, sừ gay gắt
acrimonious	- chua cay, gay gắt (lời nói, thái độ)
acrimony	- sự chua cay, sự gay gắt
acrobat	- người biểu diễn leo dây, người biểu diễn nhào lộn- nhà chính trị nghiêng ngả (dễ dàng thay đổi lập trường); nhà biện luận nghiêng ngả (dễ dàng thay đổi lập luận)
acrobatically	- tài tình, khéo léo
acrobatics	- thuật leo dây, thuật nhào lộn
acrobatism	- thuật leo dây, thuật nhào lộn
acrocarpous	- (thực vật học) có quả ở ngọn
acrogenous	- (thực vật học) sinh ở ngọn
acromegaly	- (y học) bệnh to cực
acronycal	- (thiên văn học) xuất hiện vào lúc chập tối (sao...)
acronychal	- (thiên văn học) xuất hiện vào lúc chập tối (sao...)
acronym	- từ (cấu tạo bằng) chữ đầu (của những từ khác) (ví dụ NATO,  radar...)
acropetal	- hướng ngọn
acrophobia	- (y học) chứng sợ nơi cao
acropolis	- vệ thành, thành phòng ngự (đặc biệt hay dùng để chỉ vệ thành của thành A-ten, thời cổ Hy lạp)
acrospore	- (thực vật học) bào tử ngọn
across	- qua, ngang, ngang qua- bắt chéo, chéo nhau, chéo chữ thập- qua, ngang, ngang qua- ở bên kia, ở phía bên kia- (xem) come- cãi nhau với ai- (xem) trun- (từ lóng) trả thù ai- đánh lừa ai- trừng phạt ai, sửa cho ai một trận
acrostic	- (thơ ca) chữ đầu- (thuộc) thể thơ chữ đầu, theo thể thơ chữ đầu
act	- hành động, việc làm, cử chỉ, hành vi- đạo luật- chứng thư- hồi, màn (trong vở kịch)- tiết mục (xiếc, ca múa nhạc...)- luận án, khoá luận- sắp sửa (làm gì)- khi đang hành động, quả tang- (từ lóng) khoe mẽ, nói khoe- đóng vai (kịch, chèo, tuồng, phim)- giả vờ, giả đò "đóng kịch" - hành động- cư xử, đối xử- giữ nhiệm vụ, làm công tác, làm- tác động, có tác dụng, có ảnh hưởng- đóng kịch, diễn kịch, thủ vai- (+ upon,  on) hành động theo, làm theo- (+ up to) thực hành cho xứng đáng với, hành động cho xứng đáng với
acting	- hành động- (sân khấu) nghệ thuật đóng kịch (kịch, phim, chèo, tuồng); sự thủ vai, sự đóng kịch- hành động- thay quyền, quyền
actinia	- (động vật học) hải quỳ
actiniae	- (động vật học) hải quỳ
actinic	- (vật lý),  (hoá học) quang hoá
actinism	- (vật lý),  (hoá học) tính quang hoá, độ quang hoá
actinium	- (hoá học) Actini
actinometer	- (vật lý) cái đo nhật xạ- (vật lý),  (hoá học) cái đo quang hoá
actinomorphic	- (sinh vật học) đối xứng toả tia
actinomorphous	- (sinh vật học) đối xứng toả tia
action	- hành động, hành vi; hoạt động; công việc, việc làm- tác động, tác dụng, ảnh hưởng- sự chiến đấu, trận đánh- việc kiện, sự tố tụng- sự diễn biến, quá trình diễn biến (của vở kịch)- động tác, dáng điệu, bộ điệu, bộ tịch- bộ máy, cơ cấu (đàn pianô, máy...); sự hoạt động của bộ máy- uỷ ban hành động- (quân sự) vị trí của quân đội trước khi bước vào chiến đấu- (xem) speak- kiện, thưa kiện
actionable	- có thể kiện
activate	- (hoá học); (sinh vật học) hoạt hoá, làm hoạt động- (vật lý) hoạt hoá, làm phóng xạ- (từ Mỹ,nghĩa Mỹ),  (quân sự) xây dựng và trang bị (một đơn vị)
activated	- đã hoạt hoá- đã làm phóng xạ
activation	- sự hoạt hoá- sự làm phóng xạ
active	- tích cực, hoạt động; nhanh nhẹn, linh lợi- thiết thực, thực sự; có hiệu lực, công hiệu- (ngôn ngữ học) chủ động- (quân sự) tại ngũ- (vật lý) hoạt động; phóng xạ- hoá hoạt động; có hiệu lực
actively	- tích cực hoạt động; nhanh nhẹn, linh lợi- có hiệu lực
activity	- sự tích cực, sự hoạt động, sự nhanh nhẹn, sự linh lợi- (số nhiều) hoạt động- phạm vi hoạt động- (vật lý),  (hoá học) tính hoạt động, độ hoạt động; tính phóng xạ, độ phóng xạ
actor	- diễn viên (kịch, tuồng, chèo, điện ảnh...); kép, kép hát- (từ hiếm,nghĩa hiếm) người làm (một việc gì)
actress	- nữ diễn viên, đào hát
actual	- thật sự, thật, thực tế, có thật- hiện tại, hiện thời; hiện nay
actualise	- thực hiện, biến thành hiện thực- (nghệ thuật) mô tả rất hiện thực
actuality	- thực tế, thực tại- (số nhiều) điều kiện hiện tại, điều kiện thực tế- (nghệ thuật) hiện thực
actualization	- sự thực hiện, sự biến thành hiện thực
actualize	- thực hiện, biến thành hiện thực- (nghệ thuật) mô tả rất hiện thực
actually	- thực sự, quả thật, đúng, quả là- hiện tại, hiện thời, hiện nay- ngay cả đến và hơn thế
actuary	- chuyên viên thống kê (tỷ lệ sinh đẻ, bệnh tật, thất nghiệp...)- (sử học) viên giữ sổ đăng ký; viên quản lý văn khế
actuate	- thúc đẩy, kích thích; là động cơ thúc đẩy (ai...)- phát động, khởi động
actuation	- sự thúc đẩy, sự kích thích- sự phát động, sự khởi động (máy)
acuity	- tính sắc nhọn (cái kim...); tính sắc bén, tính sắc sảo (lời nói, trí tuệ...)- (y học) độ kịch liệt (bệnh)
aculeate	- (thực vật học) có gai- (động vật học) có ngòi đốt- (nghĩa bóng) châm chọc, chua cay (lời nói)
acumen	- sự nhạy bén, sự nhạy cảm, sự thính- (thực vật học) mũi nhọn
acuminate	- (thực vật học) nhọn mũi
acupuncture	- (y học) thuật châm cứu
acute	- sắc, sắc bén, sắc sảo; nhạy, tinh, thính- buốt, gay gắc, kịch liệt, sâu sắc- (y học) cấp- (toán học) nhọn (góc)- cao; the thé (giọng, âm thanh)- (ngôn ngữ học) có dấu sắc
acuteness	- sự sắc; tính sắc bén, tính sắc sảo; tính nhạy, tính tinh, tính thính- sự buốt; tính gay gắt, tính kịch liệt, tính sâu sắc- (y học) tính cấp phát (bệnh)- (toán học) tính nhọn (góc)- tính cao; tính the thé (giọng)
ad	- (thông tục) (viết tắt) của advertisement
ad hoc	- đặc biệt- được sắp đặt trước cho mục đích đó
ad infinitum	- vô cùng, vô tận, không giới hạn, mãi mãi
ad interim	- ((viết tắt) a i) quyền, tạm quyền, tạm thời
ad valorem	- theo giá hàng
ad-lib	- (thông tục) ứng khẩu, cương- (từ Mỹ,nghĩa Mỹ),  (từ lóng) nói thêm, cương thêm (lời không có trong bản kịch); hát thêm, chơi thêm (nhạc không có trong bản nhạc)
adage	- cách ngôn, châm ngôn; ngạn ngữ
adagio	- (âm nhạc) khoan thai- (âm nhạc) nhịp khoan thai
adam	- A-dam (con người đầu tiên, thuỷ tổ loài người)- nước, nước lã- (giải phẫu) trái cổ- không biết mặt mũi như thế nào- tình trạng già yếu quá rồi (của người)
adamant	- kỉ cương- (thơ ca) cái cứng rắn, cái sắt đá- (từ cổ,nghĩa cổ) đá nam châm- cứng rắn, rắn như kim cương- sắt đá, gang thép
adamantine	- rắn như kim cương- (nghĩa bóng) cứng rắn, sắt đá, gang thép
adapt	- tra vào, lắp vào- phỏng theo, sửa lại cho hợp- làm thích nghi, làm thích ứng- thích nghi (với môi trường...)
adaptability	- tính có thể tra vào, tính có thể lắp vào- khả năng phỏng theo được, khả năng sửa lại được cho hợp- khả năng thích nghi, khả năng thích ứng
adaptable	- có thể tra vào, có thể lắp vào- có thể phỏng theo, có thể sửa lại cho hợp- có thể thích nghi, có thể thích ứng
adaptableness	- tính có thể tra vào, tính có thể lắp vào- khả năng phỏng theo được, khả năng sửa lại được cho hợp- khả năng thích nghi, khả năng thích ứng
adaptation	- sự tra vào, sự lắp vào- sự phỏng theo, sự sửa lại cho hợp- tài liệu viết phỏng theo, tài liệu sửa lại cho hợp- sự thích nghi
adapter	- người phỏng theo, người sửa lại cho hợp (tác phẩm văn học...)- người làm thích nghi, người làm thích ứng- (kỹ thuật) thiết bị tiếp hợp, ống nối, cái nắn điện
add	- ((thường) + up,  together) cộng- thêm vào, làm tăng thêm- nói thêm- (+ in) kế vào, tính vào, gộp vào- (xem) fire- miệng chửi tay đấm
addax	- (động vật học) linh dương sừng queo (Bắc Phi)
addenda	- phụ lục (của một cuốn sách); vật thêm vào, phần thêm vào
addendum	- phụ lục (của một cuốn sách); vật thêm vào, phần thêm vào
adder	- người cộng, máy cộng- rắn vipe- con chuồn chuồn
adder's tongue	- (thực vật học) cây lưỡi rắn (dương xỉ)
adder-spit	- (thực vật học) cây lưỡi rắn (dương xỉ)
addict	- người nghiện- nghiện- ham mê, say mê, miệt mài (làm việc, học tập, nghiên cứu)
addiction	- thói nghiện- sự ham mê, sự say mê
adding-machine	- máy cộng
addison's disease	- (y học) bệnh A-đi-sơn
addition	- (toán học) tính cộng; phép cộng; sự cộng lại- sự thêm, phần thêm
additional	- thêm vào, phụ vào, tăng thêm
additive	- để cộng vào, để thêm vào- vật để cộng vào, vật để thêm vào- (kỹ thuật) chất cho thêm vào (vào dầu máy...)
addle	- lẫn, quẫn, rối trí- thối, hỏng, ung (trứng)- làm lẫn, làm quẫn, làm rối óc- làm thối, làm hỏng, làm ung- lẫn, quẫn, rối (trí óc)- thối, hỏng, ung (trứng)
addle-brained	- đầu óc lẫn quẫn, quẫn trí, rối trí
addle-head	-pate) - người đầu óc lẫn quẫn
addle-pate	-pate) - người đầu óc lẫn quẫn
address	- địa chỉ- bài nói chuyện, diễn văn- cách nói năng; tác phong lúc nói chuyện- sự khéo léo, sự khôn ngoan- (số nhiều) sự ngỏ ý, sự tỏ tình, sự tán tỉnh- (thương nghiệp) sự gửi đi một chuyến tàu hàng- đề địa chỉ- gửi- xưng hô, gọi- nói với, nói chuyện với, diễn thuyết trước; viết cho- to address oneself to chăm chú, toàn tâm toàn ý- (thể dục,thể thao) nhắm
addressee	- người nhận (thư...)
adduce	- viện, viện dẫn (lý lẽ, thí dụ, bằng chứng...)
adduceable	- có thể viện dẫn (lý lẽ, thí dụ, bằng chứng...)
adducent	- (giải phẫu) khép (cơ)
adducible	- có thể viện dẫn (lý lẽ, thí dụ, bằng chứng...)
adduct	- (giải phẫu) khép (các cơ...)
adduction	- (giải phẫu) sự khép (cơ)- sự viện dẫn (lý lẽ, thí dụ, bằng chứng...)
addutor	- (giải phẫu) cơ khép
adenite	- (y học) viêm hạch
adenoids	- (y học) bệnh sùi vòm họng, bệnh V.A.
adept	- người giỏi, người tinh thông, người thông thạo, người lão luyện (nghề hay vấn đề gì)- (từ cổ,nghĩa cổ) nhà luyện đan thông thạo, nhà giả kim lão luyện- giỏi, thạo, tinh thông, lão luyện
adequacy	- sự đủ, sự đầy đủ- sự tương xứng, sự đứng đáng; sự thích hợp, sự thích đáng, sự thoả đáng
adequate	- đủ, đầy đủ- tương xứng, xứng đáng; thích hợp, thích đáng, thoả đáng
adequateness	- sự đủ, sự đầy đủ- sự tương xứng, sự đứng đáng; sự thích hợp, sự thích đáng, sự thoả đáng
adequation	- sự san bằng- vật tương đương; điều tương đương
adespota	- những tác phẩm khuyết danh
adhere	- dính chặt vào, bám chặt vào- tham gia, gia nhập- tôn trọng triệt để; trung thành với, gắn bó với; giữ vững- (từ cổ,nghĩa cổ) tán thành, đồng ý
adherence	- sự dính chặt, sự bám chặt- sự tham gia, sự gia nhập (đảng phái...)- sự tôn trọng triệt để; sự trung thành với, sự gắn bó với; sự giữ vững (ý kiến, lập trường...)
adherent	- người gia nhập đảng, đảng viên, môn đồ- người trung thành, người ủng hộ (học thuyết...)- dính chặt, bám chặt- dính liền với, có quan hệ chặt chẽ với
adherer	- người gia nhập đảng, đảng viên, môn đồ- người trung thành, người ủng hộ (học thuyết...)- dính chặt, bám chặt- dính liền với, có quan hệ chặt chẽ với
adhesion	- sự dính chặt vào, sự bám chặt vào- sự tham gia, sự gia nhập (một đảng phái)- sự trung thành với; sự giữ vững (ý kiến lập trường...)- sự tán đồng, sự đồng ý
adhesive	- dính, bám chắc- chất dính, chất dán
adhesiveness	- dính dính
adhibit	- ký (tên) vào; đóng (dấu) vào- đắp (thuốc), dán (cao...); cho uống (thuốc...)
adiabatic	- (vật lý) đoạn nhiệt
adiantum	- (thực vật học) cây đuôi chồn (dương xỉ)
adieu	- từ biệt!; vĩnh biệt!- lời chào từ biệt; lời chào vĩnh biệt
adipocere	- chất sáp mỡ (xác chết)
adipose	- mỡ động vật- béo, có mỡ
adiposis	- (y học) chứng phát phì
adiposity	- tình trạng béo phì, tình trạng phát phì
adit	- đường vào, lối vào- sự đến gần
adjacence	- sự gần kề, sự kế liền
adjacency	- sự gần kề, sự kế liền
adjacent	- gần kề, kế liền, sát ngay
adjectival	- (ngôn ngữ học) có tính chất tính từ; có chức năng tính từ
adjective	- phụ vào, thêm vào; lệ thuộc, không đứng một mình- (ngôn ngữ học) có tính chất tính từ; (thuộc) tính từ- (ngôn ngữ học) tính từ
adjoin	- nối liền, tiếp vào- gần kề với, tiếp giáp với- ở kế bên, tiếp giáp, nằm sát, sát vách
adjoining	- gần kề, kế bên, tiếp giáp, bên cạnh, sát nách
adjourn	- hoãn, hoãn lại, để lại- ngừng (buổi họp...) để sau họp lại- ngừng họp chung để họp riêng (từng ban...)- dời sang một nơi khác (để hội họp)
adjournment	- sự hoãn lại- sự dời sang một nơi khác (để hội họp); sự chuyển chỗ hội họp- sự ngừng họp (để sau này họp lại, hoặc để họp phân tán)
adjudge	- xử, xét xử, phân xử- kết án, tuyên án- cấp cho, ban cho
adjudgement	- sự xét sử, sự phân xử- sự kết án, sự tuyên án- sự cấp cho, sự ban cho
adjudgment	- sự xét sử, sự phân xử- sự kết án, sự tuyên án- sự cấp cho, sự ban cho
adjudicate	- xét xử (quan toà)- tuyên án
adjudication	- sự xét xử- sự tuyên án, quyết định của quan toà
adjudicator	- quan toà
adjunct	- điều thêm vào, cái phụ vào; vật phụ thuộc- người phụ việc, phụ tá- (ngôn ngữ học) định ngữ; bổ ngữ- (triết học) (thuộc) tính không bản chất- phụ vào; phụ thuộc- phụ, phụ tá
adjunct professor	- (từ Mỹ,nghĩa Mỹ) trợ giáo
adjunction	- sự thêm vào, sự phụ vào
adjunctive	- thêm, phụ vào; phụ thuộc
adjuration	- lời thề, lời tuyên thệ- sự khẩn nài, sự van nài
adjure	- bắt thề, bắt tuyên thệ- khẩn nài, van nài
adjust	- sửa lại cho đúng, điều chỉnh- lắp (các bộ phận cho ăn khớp)- chỉnh lý, làm cho thích hợp- hoà giải, dàn xếp (mối bất hoà, cuộc phân tranh...)
adjustable	- có thể điều chỉnh được- có thể làm cho thích hợp- có thể hoà giải được, có thể giàn xếp được (mối bất hoà, cuộc phân tranh...)
adjuster	- máy điều chỉnh- thợ lắp máy, thợ lắp ráp
adjustment	- sự sửa lại cho đúng, sự điều chỉnh, sự chỉnh lý- sự hoà giải, sự dàn xếp (mối bất hoà, cuộc phân tranh...)
adjutage	- ống vòi (ống nhỏ lắp vào miệng vòi máy nước để lấy nước)
adjutancy	- (quân sự) chức sĩ quan phụ tá; nhiệm vụ sĩ quan phụ tá
adjutant	- người phụ tá- (quân sự) sĩ quan phụ tá- (động vật học) cò già (Ân độ) ((cũng) adjutant bird,  adjutant crane,  adjutant stork)
adjuvant	- giúp đỡ, phụ tá, giúp ích- người giúp đỡ, người phụ tá; vật giúp ích
adman	- (từ Mỹ,nghĩa Mỹ) người chuyên viết quảng cáo, người chuyên vẽ quảng cáo, người làm nghề quảng cáo (hàng...)
admass	- quần chúng dễ bị thủ đoạn quảng cáo ảnh hưởng
admeasure	- quy định từng phần; chia phần ra
admeasurement	- sự quy định từng phần, sự chia phần
administer	- trông nom, quản lý; cai quản, cai trị- thi hành, thực hiện- làm lễ (tuyên thệ) cho (ai) tuyên thệ- đánh, giáng cho (đòn...)- phân tán, phân phối- cung cấp cho, cấp cho, cho (ai cái gì)- trông nom, quản lý; cai quản, cai trị- cung cấp, góp phần vào
administrate	- (từ Mỹ,nghĩa Mỹ) trông nom, quản lý; cai quản, cai trị
administration	- sự trông nom, sự quản lý; sự cai quản, sự cai trị- chính phủ, chính quyền- sự thi hành; việc áp dụng- sự cho uống (thuốc)- sự làm lễ (tuyên thệ); sự cho ai (tuyên thệ)- sự phân phối, sự phân phát (của cứu tế...)- (pháp lý) sự quản lý tài sản (của vị thành niên hoặc người đã chết)
administrative	- (thuộc) hành chính, (thuộc) quản trị- (thuộc) chính quyền, (thuộc) nhà nước
administrator	- người quản lý- người cầm quyền hành chính, người cầm quyền cai trị- (pháp lý) người quản lý tài sản (cho vị thành niên hoặc người đã chết)
administratorship	- chức vụ quản lý- chức vụ người cầm quyền cai trị- (pháp lý) chức vụ quản lý tài sản (cho vị thành niên hoặc người đã chết)
administratrices	- bà quản lý- người đàn bà cầm quyền hành chính, người đàn bà cầm quyền cai trị- bà quản lý tài sản (cho vị thành niên hoặc người đã chết)
administratrix	- bà quản lý- người đàn bà cầm quyền hành chính, người đàn bà cầm quyền cai trị- bà quản lý tài sản (cho vị thành niên hoặc người đã chết)
admirability	- tính đáng phục, tính đáng khâm phục, tính đáng ca tụng; tính đáng hâm mộ, tính ngưỡng mộ- tính tuyệt diệu, tính tuyệt vời
admirable	- đáng phục, đáng khâm phục, đáng ca tụng; đáng hâm mộ, đáng ngưỡng mộ- tuyệt diệu, tuyệt vời
admiral	- đô đốc- người chỉ huy hạm đội- người chỉ huy đoàn tàu đánh cá- tàu rồng, kỳ hạm (tàu chở thuỷ sư đô đốc)- (động vật học) bướm giáp
admiralship	- chức đô đốc
admiralty	- (Anh) bộ hải quân- chức đô đốc- chủ quyền trên mặt biển
admiration	- sự ngắm nhìn một cách vui thích- sự khâm phục, sự thán phục, sự cảm phục, sự hâm mộ, sự ngưỡng mộ; sự ca tụng- người được khâm phục, người được hâm mộ, người được ca tụng; vật được hâm mô, vật được ca tụng- (ngôn ngữ học) sự cảm thán- (từ cổ,nghĩa cổ) sự lấy làm lạ; sự ngạc nhiên
admire	- ngắm nhìn một cách vui thích- khâm phục, ((thông tục)) thán phục, cảm phục; hâm mộ, ngưỡng mộ; khen ngợi, ca tụng- say mê, mê- (từ cổ,nghĩa cổ) lấy làm lạ, lấy làm ngạc nhiên- (từ Mỹ,nghĩa Mỹ),  (thông tục) ao ước, khao khát (làm gì)
admirer	- người khâm phục, người cảm phục, người thán phục; người hâm mộ, người ngưỡng mộ; người ca tụng- người say mê (một người đàn bà)
admiring	- khâm phục, cảm phục, thán phục; ngưỡng mộ
admissibility	- tính có thể chấp nhận được, tính có thể thừa nhận được- tính có thể nhận; tính có thể thu nạp; tính có thể kết nạp
admissible	- có thể chấp nhận, có thể thừa nhận- có thể nhận, có thể thu nạp (vào chức vụ gì...); có thể kết nạp
admission	- sự nhận vào, sự thu nạp vào; sự kết nạp- sự cho vào cửa, sự cho vào- tiền vào cửa, tiền nhập học- sự nhận, sự thú nhận- (định ngữ) (kỹ thuật) nạp
admit	- nhận vào, cho vào; kết nạp (vào nơi nào, tổ chức nào...); cho hưởng (quyền lợi...)- chứa được, nhận được, có đủ chỗ cho- nhận, thừa nhận; thú nhận- (kỹ thuật) nạp- (+ of) có chỗ cho, có- nhận, thừa nhận
admittable	- có thể để cho vào (nơi nào)
admittance	- sự cho vào, sự để cho vào; sự nhận vào; sự thu nạp- lối đi vào- (vật lý) sự dẫn nạp; độ dẫn nạp
admittedly	- phải nhận, phải thừa nhận, phải thú nhận
admix	- trộn lẫn, hỗn hợp
admixture	- sự trộn lẫn, sự hỗn hợp- vật lộn
admonish	- khiển trách, quở mắng, la rầy- răn bảo, khuyên răn, khuyên nhủ; động viên- (+ of) cảnh cáo; báo cho biết trước- (+ of) nhắc, nhắc nhở
admonishment	- sự khiển trách, sự quở mắng, sự la rầy- sự răn bảo lời khuyên răn, lời khuyên nhủ, lời động viên- sự cảnh cáo, lời cảnh cáo- sự nhắc nhở, lời nhắc nhở
admonition	- sự khiển trách, sự quở mắng, sự la rầy- sự răn bảo lời khuyên răn, lời khuyên nhủ, lời động viên- sự cảnh cáo, lời cảnh cáo- sự nhắc nhở, lời nhắc nhở
admonitory	- khiển trách, quở mắng, la rầy- răn bảo, khuyên răn, khuyên nhủ; động viên- cảnh cáo- nhắc nhở
adnate	- (sinh vật học) hợp sinh
adnoun	- (ngôn ngữ học) tính từ, danh tính từ
ado	- việc làm, công việc- sự khó nhọc, sự khó khăn, công sức- sự rối rít, sự hối hả ngược xuôi
adobe	- gạch sống (phơi nắng, không nung)
adolescence	- thời thanh niên
adolescency	- thời thanh niên
adolescent	- đang tuổi thanh niên, trẻ- người thanh niên
adonis	- (thần thoại,thần học) A-đô-nít (người yêu của thần Vệ nữ)- người thanh niên đẹp trai- (thực vật học) cỏ phúc thọ- (động vật học) bướm ađônít
adonize	- làm dáng, làm ra vẻ người đẹp trai ((cũng) to adonize oneself)
adopt	- nhận làm con nuôi; nhận làm bố mẹ nuôi- theo, làm theo- chọn (nghề, người cho một chức vị)- (từ Mỹ,nghĩa Mỹ) chấp nhận và thực hiện
adoptability	- tính có thể nhận làm con nuôi; tính có thể nhận làm bố mẹ nuôi- tính có thể theo được, tính có, thể làm theo- tính có thể chọn được- (từ Mỹ,nghĩa Mỹ) tính có thể chấp nhận và thực hiện
adoptable	- có thể nhận làm con nuôi; có thể nhận làm bố mẹ nuôi- có thể theo được, có thể làm theo- có thể chọn được- (từ Mỹ,nghĩa Mỹ) có thể chấp nhận và thực hiện
adoptee	- con nuôi
adopter	- người nhận nuôi
adoption	- sự nhận làm con nuôi; sự nhận làm bố mẹ nuôi- sự theo, sự làm theo (phương pháp...)- sự chọn (nghề, người cho một chức vị)- (từ Mỹ,nghĩa Mỹ) sự chấp nhận và thực hiện (lời đề nghị...)
adoptive	- nuôi; nhận nuôi
adorability	- tính đáng yêu, tính đáng quý mến, tính đáng yêu, tính đáng quý mến- (thơ ca) tính đáng tôn sùng, tính đáng sùng bái, tính đáng tôn thờ
adorable	- đáng kính yêu, đáng quý mến, đáng yêu- (thơ ca) đáng tôn sùng, đáng sùng bái, đáng tôn thờ
adorableness	- tính đáng yêu, tính đáng quý mến, tính đáng yêu, tính đáng quý mến- (thơ ca) tính đáng tôn sùng, tính đáng sùng bái, tính đáng tôn thờ
adoration	- sự kính yêu, sự quý mến- sự mê thích, sự hết sức yêu chuộng, sự yêu thiết tha- (thơ ca) sự tôn sùng, sự sùng bái, sự tôn thờ
adore	- kính yêu, quý mến- mê, thích, hết sức yêu chuộng, yêu thiết tha- (thơ ca) tôn sùng, sùng bái, tôn thờ
adorer	- người hâm mộ, người yêu chuộng, người yêu- (thơ ca) người tôn sùng, người sùng bái, người tôn thờ
adorn	- tô điểm, trang điểm; trang trí, trang hoàng
adornment	- sự tô điểm, sự trang trí, sự trang hoàng- đồ trang điểm; đồ trang trí
adown	- (từ cổ,nghĩa cổ); (thơ ca) ở dưới, xuống, xuống dưới
adrenal	- (giải phẫu) trên thận, thượng thận- (giải phẫu) tuyến trên thận, tuyến thượng thận
adrenalin	- (y học) Adrenalin
adrift	- lênh đênh trôi giạt, phiêu bạt ((nghĩa đen) & (nghĩa bóng))- (hàng hải) không buộc- lênh đênh, trôi giạt, phiêu bạt ((nghĩa đen) & (nghĩa bóng))
adroit	- khéo léo, khéo tay
adroitness	- sự khéo léo, sự khéo tay
adscititious	- phụ vào, thêm vào, bổ sung
adsorb	- (hoá học) hút bám
adsorbate	- (hoá học) chất bị hút bám
adsorbent	- (hoá học) hút bám
adsorber	- (hoá học) máy hút bám
adsorption	- (hoá học) sự hút bám
adulate	- nịnh hót, nịnh nọt, bợ đỡ
adulation	- sự nịnh hót, sự nịnh nọt, sự bợ đỡ
adulator	- kẻ nịnh hót, kẻ nịnh nọt, kẻ bợ đỡ
adulatory	- nịnh hót, nịnh nọt, bợ đỡ
adult	- người lớn, người đã trưởng thành- trưởng thành
adulterant	- để làm giả- chất để làm giả
adulterate	- có pha (rượu)- giả, giả mạo (vật)- ngoại tình, thông dâm- pha, pha trộn- àm giả mạo
adulteration	- sự pha, sự pha trộn- vật bị pha trộn- sự làm giả, sự giả mạo (tiền...)
adulterer	- người đàn ông ngoại tình, người đàn ông thông dâm
adulteress	- người đàn bà ngoại tình, người đàn bà thông dâm
adulterine	- do ngoại tình mà đẻ ra- giả mạo, giả- bất chính, không hợp pháp
adulterous	- ngoại tình, thông dâm
adultery	- tội ngoại tình, tội thông dâm
adulthood	- tuổi khôn lớn, tuổi trưởng thành
adumbral	- nhiều bóng râm
adumbrate	- phác hoạ- cho biết lờ mờ- làm cho biết trước, báo trước bằng điềm- che tối, làm cho mờ tối, toả bóng xuống
adumbration	- sự phác hoạ, bản phác hoạ- sự cho biết, lờ mờ; hình ảnh lờ mờ- sự báo trước, điềm báo trước- sự che chở, sự toả bóng, bóng tối, bóng râm
adust	- cháy khô, khô nứt ra (vì ánh mặt trời...)- buồn bã, u sầu, rầu rĩ (tính tình)
advance	- sự tiến lên, sự tiến tới, sự tiến bộ- sự đề bạt, sự thăng, chức- sự tăng giá- tiền đặt trước, tiền trả trước- tiền cho vay- sự theo đuổi, sự làm thân- (điện học) sự sớm pha- bản (sách, tài liệu, ...) đưa (cho tác giả...) trước khi xuất bản- trước, sớm- trước, đi trước- đưa lên, đưa ra phía trước- đề xuất, đưa ra- đề bạt, thăng chức (cho ai)- làm cho tiến bộ, làm tiến mau (khoa học...)- thúc đẩy (sự việc...)- tăng, tăng lên- trả trước, đặt trước- cho vay (tiền)- tiến lên, tiến tới, tiến bộ- tăng, tăng lên
advance-guard	- (quân sự) quân tiền phong
advanced	- tiên tiến, tiến bộ, cấp tiến- cao, cấp cao
advancement	- sự tiến lên, sự tiến tới, sự tiến bộ; sự thúc đẩy, sự làm cho tiến lên- sự thăng chức, đề bạt- (pháp lý) tiền (người kế thừa được) nhận trước
advantage	- sự thuận lợi, hoàn cảnh thuận lợi; mối lợi- thế lợi- bất ngờ chộp được ai, thình lình chộp được ai- đem lợi ích cho, có lợi cho, mang thuận lợi cho- giúp cho; thúc đẩy, làm cho tiến lên
advantageous	- có lợi, thuận lợi
advantageousness	- tính có lợi, tính thuận lợi
advent	- sự đến, sự tới (của một sự việc gì quan trọng)- Advent (tôn giáo) sự giáng sinh của Chúa Giêxu- Advent (tôn giáo) kỳ trông đợi (bốn tuần lễ trước ngày giáng sinh của Chúa)
adventitious	- ngẫu nhiên, tình cờ- ngoại lai- (pháp lý) không do thừa kế trực tiếp- (thực vật học) tự sinh, mọc tự nhiên (cây...)- (thực vật học) bất định, không phát sinh ở nơi thông thường
adventitiousness	- tính ngẫu nhiên, tính tình cờ- tính chất ngoại lai
adventure	- phiêu lưu, mạo hiểm, liều- dám đi, dám đến (nơi nào...)- dám tiến hành (cuộc kinh doanh...)- sự phiêu lưu, sự mạo hiểm; việc làm mạo hiểm, việc làm táo bạo- sự nguy hiểm, sự hiểm nghèo- sự việc bất ngờ- sự may rủi, sự tình cờ- (thương nghiệp) sự đầu cơ
adventurer	- người phiêu lưu, người mạo hiểm, người thích phiêu lưu mạo hiểm- (thương nghiệp) người đầu cơ- kẻ đại bợm, kẻ gian hùng- kẻ sẵn sàng sung vào quân đội đánh thuê (cho bất cứ nước nào để kiếm tiền)
adventuresome	- (từ hiếm,nghĩa hiếm) (như) adventurous
adventuress	- người đàn bà thích phiêu lưu mạo hiểm- mụ đầu cơ- mụ đại bợm, mụ gian hùng
adventurism	- chủ nghĩa phiêu lưu
adventurous	- thích phiêu lưu, thích mạo hiểm, phiêu lưu, mạo hiểm- liều lĩnh
adventurousness	- tính phiêu lưu, tính mạo hiểm- tính liều lĩnh
adverb	- (ngôn ngữ học) phó từ
adverbial	- (ngôn ngữ học) (thuộc) phó từ; có tính chất phó từ
adversary	- kẻ địch, kẻ thù; đối phương, đối thủ
adversative	- (ngôn ngữ học) đối lập
adverse	- đối địch, thù địch, nghịch lại, chống đối- bất lợi, có hại- ngược- bên kia, đối diện
adversity	- sự bất hạnh; vận đen, vận rủi; cảnh nghịch, vận nghịch- tai hoạ, tai ương
advert	- ám chỉ (nói hoặc viết); nói đến, kể đến- tai hoạ, tai ương
advertence	- sự chú ý, sự lưu ý
advertency	- sự chú ý, sự lưu ý
advertise	- báo cho biết, báo cho ai biết trước- quảng cáo (hàng)- đăng báo; yết thị; thông báo (cho mọi người biết)
advertisement	- sự quảng cáo; bài quảng cáo (trên báo, trên đài...)- tờ quảng cáo; tờ yết thị; tờ thông báo (dán trên tường...)- cột quảng cáo, mục quảng cáo
advertiser	- người báo cho biết trước- người quảng cáo; báo đăng quảng cáo; tờ quảng cáo
advertize	- báo cho biết, báo cho ai biết trước- quảng cáo (hàng)- đăng báo; yết thị; thông báo (cho mọi người biết)
advice	- lời khuyên, lời chỉ bảo- ((thường) số nhiều) tin tức- theo những tin tức cuối cùng chúng tôi nhận được- (số nhiều) (thương nghiệp) thư thông báo ((cũng) letter of advice)
advisability	- tính chất nên, tính chất thích hợp, tính chất đáng theo- tính chất khôn, tính chất khôn ngoan
advisable	- nên, thích hợp, đáng theo- khôn, khôn ngoan
advisableness	- tính chất nên, tính chất thích hợp, tính chất đáng theo- tính chất khôn, tính chất khôn ngoan
advise	- khuyên, khuyên bảo, răn bảo- (thương nghiệp) báo cho biết- hỏi ý kiến
advised	- am hiểu, hiểu biết- đúng, đúng đắn, chí lý- có suy nghĩ thận trọng
advisedly	- có suy nghĩ chín chắn, thận trọng
adviser	- người khuyên bảo, người chỉ bảo, cố vấn
advisor	- người khuyên bảo, người chỉ bảo, cố vấn
advisory	- để hỏi, để xin ý kiến; cho ý kiến, cố vấn
advocacy	- nhiệm vụ luật sư- lời biện hộ của luật sư; sự bào chữa (cho ai)- sự ủng hộ tích cực (một sự nghiệp)
advocate	- người biện hộ, người bào chữa, người bênh vực; luật sư, thầy cãi- người chủ trương; người tán thành, người ủng hộ- biện hộ, bào chữa- chủ trương; tán thành, ủng hộ
adynamia	- (y học) chứng mệt lử; sự kiệt sức
adynamic	- (y học) mệt lử, kiệt sức
adyta	- chính điện (ở giáo đường)- thâm cung; buồng riêng
adytum	- chính điện (ở giáo đường)- thâm cung; buồng riêng
adz	- rìu lưỡi vòm- đẽo bằng rìu lưỡi vòm
adze	- rìu lưỡi vòm- đẽo bằng rìu lưỡi vòm
aeger	- giấy chứng nhận ốm (cho học sinh các trường đại học Anh)
aegis	- sự che chở, sự bảo hộ, sự bảo vệ
aegrotat	- giấy chứng nhận ốm nặng không dự thi được (của học sinh các trường đại học Anh)
aelotropic	- (vật lý) dị hướng
aelotropy	- (vật lý) tính dị hướng
aeon	- thời đại, niên kỷ- sự vĩnh viễn; khoảng thời gian vô tận
aerate	- làm thông khí, quạt gió- cho hơi vào, cho khí cacbonic vào (nước uống, đồ giải khát...)- (y học) làm cho (máu) lấy oxy (qua hô hấp)- làm cho hả mùi (sữa) (bằng cách rót thành lớp mỏng)
aeration	- sự làm thông, sự quạt gió- cho hơi vào, cho khí cacbonic vào- (y học) sự làm cho (máu) lấy oxy- làm cho hả mùi (sữa)
aerial	- ở trên trời, trên không- (thuộc) không khí; nhẹ như không khí- không thực, tưởng tượng- rađiô dây trời, dây anten
aerie	- tổ chim làm tít trên cao (của chim săn mồi)- ổ trứng ấp (của chim săn mồi)- nhà làm trên đỉnh núi
aeriform	- dạng hơi- không thực
aerify	- làm hoá ra thể hơi, khí hoá
aero-engine	- động cơ máy bay
aerobatics	- sự nhào lộn trên không (của máy bay)
aerobe	- vi sinh vật ưa khí
aerobiology	- khoa sinh vật không khí (nghiên cứu các vi sinh vật và bào tử trong không khí)
aerocamera	- máy ảnh chụp trên không (chụp từ máy bay)
aerocarrier	- tàu sân bay
aerodrome	- sân bay
aerodynamic	- khí động lực
aerodynamical	- khí động lực
aerodynamics	- khí động lực học
aerodyne	- máy bay nặng hơn không khí
aeroembolism	- (y học) bệnh khí ép
aerofoil	- cánh máy bay
aerogram	- bức điện rađiô
aerogun	- súng gắn trên máy bay
aerolite	- đá trời, thiên thạch
aerology	- (vật lý) môn quyển khí- (khí tượng) môn khí tượng cao không
aeromechanics	- cơ học chất khí
aerometer	- cái đo tỷ trọng khí
aeronaut	- nhà hàng không; người lái khí cầu
aeronautic	- (thuộc) hàng không
aeronautical	- (thuộc) hàng không
aeronautics	- hàng không học
aeronavigation	- thuật hàng không
aerophotograph	- ảnh chụp từ máy bay
aerophotography	- sự chụp ảnh từ máy bay; phép chụp ảnh từ máy bay
aeroplane	- máy bay, tàu bay
aeroport	- sân bay lớn
aerostat	- khí cầu
aerostatics	- (số nhiều dùng như số ít) khí cầu học- khí tĩnh học
aerotechnics	- kỹ thuật hàng không
aeruginous	- có tính chất gỉ đồng; giống màu gỉ đồng
aery	- tổ chim làm tít trên cao (của chim săn mồi)- ổ trứng ấp (của chim săn mồi)- nhà làm trên đỉnh núi
aesthete	- nhà thẩm mỹ
aesthetic	- (thuộc) mỹ học, thẩm mỹ- có óc thẩm mỹ, có khiếu thẩm mỹ; hợp với nguyên tắc thẩm mỹ
aesthetically	- có thẩm mỹ- về mặt thẩm mỹ
aesthetics	- mỹ học
aestho-physiology	- sinh lý học giác quan
aestival	- (thuộc) mùa hạ; sinh vào mùa hạ
aestivate	- (động vật học) ngủ hè
aestivation	- (động vật học) sự ngủ hè
aetiology	- thuyết nguyên nhân- (y học) khoa nguyên nhân bệnh
afar	- xa, ở xa, cách xa
affability	- sự lịch sự, sự nhã nhặn, sự hoà nhã; sự niềm nở, sự ân cần
affable	- lịch sự, nhã nhặn, hoà nhã; niềm nở, ân cần
affableness	- sự lịch sự, sự nhã nhặn, sự hoà nhã; sự niềm nở, sự ân cần
affair	- việc- (số nhiều) công việc, việc làm, sự vụ- chuyện tình, chuyện yêu đương- chuyện vấn đề- việc buôn bán; việc giao thiệp- (thông tục) cái, thứ, vật, đồ, món, chuyện- (quân sự) trận đánh nhỏ
affect	- làm ảnh hưởng đến, làm tác động đến; chạm đến- làm xúc động, làm cảm động, làm mủi lòng- làm nhiễm phải, làm mắc (bệnh)- (từ cổ,nghĩa cổ) (thường) dạng bị động- bổ nhiệm- giả vờ, giả bộ, làm ra vẻ- có hình dạng, thành hình- dùng, ưa dùng, thích- thích ăn mặc quần áo hào nhoáng- (từ cổ,nghĩa cổ) yêu dấu, âu yếm- (tâm lý học) sự xúc động
affectation	- sự điệu bộ, sự màu mè, sự không tự nhiên- sự giả vờ, sự giả bô, sự làm ra vẻ- (từ hiếm,nghĩa hiếm) sự bổ nhiệm, sự sử dụng (vào một việc gì)
affected	- (+ to,  towards) có ý (tốt, xấu... đối với ai)- xúc động- bị mắc, bị nhiễm (bệnh...)- giả tạo, điệu bộ, màu mè, không tự nhiên
affectedly	- giả tạo, điệu bộ, màu mè, không tự nhiên
affecting	- làm xúc động, làm cảm động, làm mủi lòng
affection	- sự làm ảnh hưởng đến, sự làm tác động đến- tình cảm, cảm xúc- ((thường) + towards,  for) lòng yêu thương, sự yêu mến, tình cảm, thiện ý- bệnh tật, bệnh hoạn- affection towards khuynh hướng, thiện ý về- tính chất, thuộc tính- trạng thái cơ thể (do bị một cái gì tác động vào...)- lối sống
affectionate	- thương yêu, yêu mến, âu yếm; trìu mến
affectionateness	- tính hay thương yêu, tính thương mến; tính trìu mến
affective	- xúc động, dễ xúc động
affectivity	- tính dễ xúc động
afferent	- (sinh vật học) hướng vào, dẫn vào, hướng tâm
affettuoso	- (âm nhạc) âu yếm
affiance	- (+ in,  on) sự tin, sự tín nhiệm- lễ ăn hỏi, lễ đính hôn- (thường) dạng bị động đính hôn, hứa hôn
affidavit	- (pháp lý) bản khai có tuyên thệ- (thông tục) làm một bản khai có tuyên thệ
affiliate	- nhận làm chi nhánh, nhận làm hội viên- (+ to,  with) nhập, liên kết (tổ chức này vào một tổ chức khác)- (pháp lý) xác định tư cách làm bố (một đứa con hoang để có trách nhiệm nuôi)- xác định tư cách tác giả (của một tác phẩm)- tìm nguồn gốc (ngôn ngữ)
affiliation	- sự nhập hội, sự nhập đoàn- sự sáp nhập, sự nhập vào, sự liên kết- (pháp lý) sự xác định tư cách làm bố (một đứa con hoang để có trách nhiệm nuôi)- sự xác định tư cách tác giả (của một tác phẩm)- sự tìm nguồn gốc (ngôn ngữ)
affinage	- (kỹ thuật) sự tinh luyện, sự tinh chế
affined	- có quan hệ họ hàng
affinity	- mối quan hệ, sự giống nhau về cấu trúc (giữa các loài vật, cây cỏ, ngôn ngữ)- sự giống nhau về tính tình- quan hệ thân thuộc với họ nhà vợ, quan hệ thân thuộc với họ nhà chồng- sự thu hút, sự hấp dẫn, sự lôi cuốn; sự đồng cảm- sự ham thích- (hoá học) ái lực
affirm	- khẳng định, xác nhận; quả quyết- (pháp lý) xác nhân, phê chuẩn
affirmation	- sự khẳng định, sự xác nhận; sự quả quyết- lời khẳng định, lời xác nhận; lời quả quyết- (pháp lý) sự xác nhận; sự phê chuẩn
affirmative	- khẳng định; quả quyết- lời khẳng định; lời nói "ừ" , lời nói "được" 
affix	- sự thêm vào; phần thêm vào- (ngôn ngữ học) phụ tổ- affix to,  on,  upon) đóng chặt vào, gắn vào, đính vào- đóng (dấu); dán (tem); ký (tên...)
affixture	- sự đóng chặt vào, sự gắn vào, sự đính vào
afflatus	- cảm hứng- linh cảm
afflict	- làm đau đớn, làm đau buồn, làm ưu phiền, làm khổ sở
affliction	- nỗi đau đớn, nỗi đau buồn, nỗi ưu phiền, nỗi khổ sở- tai ách, tai hoạ, hoạn nạn
afflictive	- làm đau đớn, làm đau buồn, làm ưu phiền, làm khổ sở- mang tai hoạ, mang hoạn nạn
affluence	- sự tụ họp đông (người)- sự giàu có, sự sung túc, sự phong phú, sự dồi dào
affluent	- nhiều, dồi dào, phong phú- giàu có- sông nhánh
afflux	- sự đổ dồn (về một nơi); sự chảy dồn, sự chảy tụ lại
afford	- có thể, có đủ sức, có đủ khả năng, có đủ điều kiện (để làm gì)- cho, tạo cho, cấp cho, ban cho
afforest	- trồng cây gây rừng; biến thành rừng- (sử học) biến thành khu vực săn bắn
afforestation	- sự trồng cây gây rừng; sự biến thành rừng- (sử học) sự biến thành khu vực săn bắn
afforestment	- sự trồng cây gây rừng; sự biến thành rừng- (sử học) sự biến thành khu vực săn bắn
affranchise	- giải phóng
affranchisement	- sự giải phóng
affray	- sự huyên náo; cuộc ẩu đả, cuộc cãi lộn (ở nơi công cộng)
affreightment	- (hàng hải) sự thuê tàu, chở hàng
affricate	- (ngôn ngữ học) âm tắc xát
affright	- (thơ ca); (từ cổ,nghĩa cổ) sự khiếp sợ, sự hoảng sợ, sự khiếp đảm- nỗi kinh hãi- (thơ ca); (từ cổ,nghĩa cổ) làm khiếp sợ, làm hoảng sợ, làm khiếp đảm
affront	- sự lăng mạ, sự lăng nhục, sự sỉ nhục- lăng mạ, lăng nhục, sỉ nhục- làm nhục, làm xấu hổ, làm mất thể diện- đương đầu
affusion	- sự rảy nước, sự giội nước (khắp người để làm lễ rửa tội)- (y học) sự giội nước (cho người sốt); phép chữa giội nước
afghan	- người Ap-ga-ni-xtăng- tiếng Ap-ga-ni-xtăng- afghan (từ Mỹ,nghĩa Mỹ) khăn phủ giường bằng len đan
afield	- ở ngoài đồng, ở ngoài ruộng; ra đồng, ra ruộng- xa; ở xa- xa nhà ((thường) far afield)- (quân sự) ở ngoài mặt trận
afire	- cháy, bừng bừng, rực cháy (nghĩa đen) & (nghĩa bóng)
aflame	- cháy, rực cháy, rực lửa ((nghĩa đen) & (nghĩa bóng)), bốc lửa
afloat	- nổi lênh đênh (trên mặt nước), lơ lửng (trên) không)- trên biển, trên tàu thuỷ- ngập nước- lan truyền đi (tin đồn)- thịnh vượng, hoạt động sôi nổi- hết nợ, sạch mợ, không mắc nợ ai- đang lưu hành- không ổn định, trôi nổi
afoot	- đi bộ, đi chân- đang tiến hành, đang làm- trở dậy; hoạt động
afore	- (hàng hải) ở phía trước, ở đằng trước- (từ cổ,nghĩa cổ) trước đây, trước kia
aforecited	- đã dẫn
aforegoing	- xảy ra trước đây